50
7
1
1
##################################################
#.###........#...............#..............######
#.###.######.#..###########..#..##.#######..######
#.###.######.#............#..#..##.#######.......|
#.###.######.############.#..#..##.#######.......|
#.....######..............#.....##.###############
##################################################
