50
7
2
5
##################################################
#.###........*...............#####.......*..######
#.##########.*..###########..#..##.###.###..######
#.#######....#............#..#..##.###.###.......|
#.#######.##.############.#..#..##.###.###.......|
#.........##..............##.......###.....#######
##################################################
