50
9
2
5
##################################################
#.###........###........###..#####..........######
#.###..###########..########.#####.##..###########
#.###..##....#............#..#####.###.####......#
#.####.##.##.############.#..#####.###.####.*....|
#.........##..............##.......###......######
#########################....#####################
