50
8
2
5
##################################################
########......###################......######...##
##.#####.####....*...........####.####.######.####
##.#####.####.#######.######.####.####*####....###
##.#####.####.#######.######.####......####.##.###
##.......####.#######.######..###.####.####.##.###
#############.........#######......*........##...|
##################################################
