50
20
2
5
##################################################
#................................................#
#.........**********.............................#
#...........##############.......................|
#...........#............################........|
#..........*#*********...........................#
#......*****#*******.............................#
#.******....#....................................#
#...........#....................................#
#...........#....................................#
#................................................#
#................................................#
#................................................#
#................................................#
#................................................#
#................................................#
#................................................#
#................................................#
#................................................#
##################################################